> Genome: IMT24775 | Promoter-Region (Gene): map_eap
CGATAACATATAAACGTTATGACTGACTAACTTCAAATCAGTATCATCTTTCTTAGATTC
GGCTTTGGCACTATTGTCTGTCAGTGCCCCAATTAATAATAAATTTGCTAATGCAAGTGT
TGCAGCTTTTTTTAGTGTGTTGGATTTTGTTTTTTTCACCATCATTATCACTCCTTTTAT
ATAGCTTACAACAAAATAGATGCAAAATTGATTAACTAAATTTAAATTAATTATTAAATC
GAATTTATATTTTTGAGTAAATGTTTTTTGAGTATAAAGATGCTATAAATATAATTGACA
AATGTAATCGGAATTAAGAAATGAAGGTTGTAATGACATTTAAGTTTAAAGCTTGGTATA
AACAAAATCAAACAACATTTTAGGTATTGTAAATTAATTAGTTAATCAAAATTAAAAGAA
CTTTTAACAGTGTTAAAAAATTATTGTTAAAGATAATTTATTATTAATATTCAGTTAATT
CAAAAAATAGAGAAAGTCTGGCTATAATTAAGTTGCAATCACGAATTACATAAAAAAGGA
GAGATAATTT
> Genome: IMT24784 | Promoter-Region (Gene): map_eap
CGATAACATATAAACGTTATGACTGACTAACTTCAAATCAGTATCATCTTTCTTAGATTC
GGCTTTGGCACTATTGTCTGTCAGTGCCCCAATTAATAATAAATTTGCTAATGCAAGTGT
TGCAGCTTTTTTTAGTGTGTTGGATTTTGTTTTTTTCACCATCATTATCACTCCTTTTAT
ATAGCTTACAACAAAATAGATGCAAAATTGATTAACTAAATTTAAATTAATTATTAAATC
GAATTTATATTTTTGAGTAAATGTTTTTTGAGTATAAAGATGCTATAAATATAATTGACA
AATGTAATCGGAATTAAGAAATGAAGGTTGTAATGACATTTAAGTTTAAAGCTTGGTATA
AACAAAATCAAACAACATTTTAGGTATTGTAAATTAATTAGTTAATCAAAATTAAAAGAA
CTTTTAACAGTGTTAAAAAATTATTGTTAAAGATAATTTATTATTAATATTCAGTTAATT
CAAAAAATAGAGAAAGTCTGGCTATAATTAAGTTGCAATCACGAATTACATAAAAAAGGA
GAGATAATTT
> Genome: IMT25053 | Promoter-Region (Gene): map_eap
CGATAACATATAAACGTTATGACTGACTAACTTCAAATCAGTATCATCTTTCTTAGATTC
GGCTTTGGCACTATTGTCTGTCAGTGCCCCAATTAATAATAAATTTGCTAATGCAAGTGT
TGCAGCTTTTTTTAGTGTGTTGGATTTTGTTTTTTTCACCATCATTATCACTCCTTTTAT
ATAGCTTACAACAAAATAGATGCAAAATTGATTAACTAAATTTAAATTAATTATTAAATC
GAATTTATATTTTTGAGTAAATGTTTTTTGAGTATAAAGATGCTATAAATATAATTGACA
AATGTAATCGGAATTAAGAAATGAAGGTTGTAATGACATTTAAGTTTAAAGCTTGGTATA
AACAAAATCAAACAACATTTTAGGTATTGTAAATTAATTAGTTAATCAAAATTAAAAGAA
CTTTTAACAGTGTTAAAAAATTATTGTTAAAGATAATTTATTATTAATATTCAGTTAATT
CAAAAAATAGAGAAAGTCTGGCTATAATTAAGTTGCAATCACGAATTACATAAAAAAGGA
GAGATAATTT
> Genome: IMT25280 | Promoter-Region (Gene): map_eap
CGATAACATATAAACGTTATGACTGACTAACTTCAAATCAGTATCATCTTTCTTAGATTC
GGCTTTGGCACTATTGTCTGTCAGTGCCCCAATTAATAATAAATTTGCTAATGCAAGTGT
TGCAGCTTTTTTTAGTGTGTTGGATTTTGTTTTTTTCACCATCATTATCACTCCTTTTAT
ATAGCTTACAACAAAATAGATGCAAAATTGATTAACTAAATTTAAATTAATTATTAAATC
GAATTTATATTTTTGAGTAAATGTTTTTTGAGTATAAAGATGCTATAAATATAATTGACA
AATGTAATCGGAATTAAGAAATGAAGGTTGTAATGACATTTAAGTTTAAAGCTTGGTATA
AACAAAATCAAACAACATTTTAGGTATTGTAAATTAATTAGTTAATCAAAATTAAAAGAA
CTTTTAACAGTGTTAAAAAATTATTGTTAAAGATAATTTATTATTAATATTCAGTTAATT
CAAAAAATAGAGAAAGTCTGGCTATAATTAAGTTGCAATCACGAATTACATAAAAAAGGA
GAGATAATTT
> Genome: IMT26595 | Promoter-Region (Gene): map_eap
CGATAACATATAAACGTTATGACTGACTAACTTCAAATCAGTATCATCTTTCTTAGATTC
GGCTTTGGCACTATTGTCTGTCAGTGCCCCAATTAATAATAAATTTGCTAATGCAAGTGT
TGCAGCTTTTTTTAGTGTGTTGGATTTTGTTTTTTTCACCATCATTATCACTCCTTTTAT
ATAGCTTACAACAAAATAGATGCAAAATTGATTAACTAAATTTAAATTAATTATTAAATC
GAATTTATATTTTTGAGTAAATGTTTTTTGAGTATAAAGATGCTATAAATATAATTGACA
AATGTAATCGGAATTAAGAAATGAAGGTTGTAATGACATTTAAGTTTAAAGCTTGGTATA
AACAAAATCAAACAACATTTTAGGTATTGTAAATTAATTAGTTAATCAAAATTAAAAGAA
CTTTTAACAGTGTTAAAAAATTATTGTTAAAGATAATTTATTATTAATATTCAGTTAATT
CAAAAAATAGAGAAAGTCTGGCTATAATTAAGTTGCAATCACGAATTACATAAAAAAGGA
GAGATAATTT
> Genome: IMT26596 | Promoter-Region (Gene): map_eap
CGATAACATATAAACGTTATGACTGACTAACTTCAAATCAGTATCATCTTTCTTAGATTC
GGCTTTGGCACTATTGTCTGTCAGTGCCCCAATTAATAATAAATTTGCTAATGCAAGTGT
TGCAGCTTTTTTTAGTGTGTTGGATTTTGTTTTTTTCACCATCATTATCACTCCTTTTAT
ATAGCTTACAACAAAATAGATGCAAAATTGATTAACTAAATTTAAATTAATTATTAAATC
GAATTTATATTTTTGAGTAAATGTTTTTTGAGTATAAAGATGCTATAAATATAATTGACA
AATGTAATCGGAATTAAGAAATGAAGGTTGTAATGACATTTAAGTTTAAAGCTTGGTATA
AACAAAATCAAACAACATTTTAGGTATTGTAAATTAATTAGTTAATCAAAATTAAAAGAA
CTTTTAACAGTGTTAAAAAATTATTGTTAAAGATAATTTATTATTAATATTCAGTTAATT
CAAAAAATAGAGAAAGTCTGGCTATAATTAAGTTGCAATCACGAATTACATAAAAAAGGA
GAGATAATTT
> Genome: IMT27910 | Promoter-Region (Gene): map_eap
CGATAACATATAAACGTTATGACTGACTAACTTCAAATCAGTATCATCTTTCTTAGATTC
GGCTTTGGCACTATTGTCTGTCAGTGCCCCAATTAATAATAAATTTGCTAATGCAAGTGT
TGCAGCTTTTTTTAGTGTGTTGGATTTTGTTTTTTTCACCATCATTATCACTCCTTTTAT
ATAGCTTACAACAAAATAGATGCAAAATTGATTAACTAAATTTAAATTAATTATTAAATC
GAATTTATATTTTTGAGTAAATGTTTTTTGAGTATAAAGATGCTATAAATATAATTGACA
AATGTAATCGGAATTAAGAAATGAAGGTTGTAATGACATTTAAGTTTAAAGCTTGGTATA
AACAAAATCAAACAACATTTTAGGTATTGTAAATTAATTAGTTAATCAAAATTAAAAGAA
CTTTTAACAGTGTTAAAAAATTATTGTTAAAGATAATTTATTATTAATATTCAGTTAATT
CAAAAAATAGAGAAAGTCTGGCTATAATTAAGTTGCAATCACGAATTACATAAAAAAGGA
GAGATAATTT
> Genome: IMT27969 | Promoter-Region (Gene): map_eap
CGATAACATATAAACGTTATGACTGACTAACTTCAAATCAGTATCATCTTTCTTAGATTC
GGCTTTGGCACTATTGTCTGTCAGTGCCCCAATTAATAATAAATTTGCTAATGCAAGTGT
TGCAGCTTTTTTTAGTGTGTTGGATTTTGTTTTTTTCACCATCATTATCACTCCTTTTAT
ATAGCTTACAACAAAATAGATGCAAAATTGATTAACTAAATTTAAATTAATTATTAAATC
GAATTTATATTTTTGAGTAAATGTTTTTTGAGTATAAAGATGCTATAAATATAATTGACA
AATGTAATCGGAATTAAGAAATGAAGGTTGTAATGACATTTAAGTTTAAAGCTTGGTATA
AACAAAATCAAACAACATTTTAGGTATTGTAAATTAATTAGTTAATCAAAATTAAAAGAA
CTTTTAACAGTGTTAAAAAATTATTGTTAAAGATAATTTATTATTAATATTCAGTTAATT
CAAAAAATAGAGAAAGTCTGGCTATAATTAAGTTGCAATCACGAATTACATAAAAAAGGA
GAGATAATTT
> Genome: IMT32934 | Promoter-Region (Gene): map_eap
CGATAACATATAAACGTTATGACTGACTAACTTCAAATCAGTATCATCTTTCTTAGATTC
GGCTTTGGCACTATTGTCTGTCAGTGCCCCAATTAATAATAAATTTGCTAATGCAAGTGT
TGCAGCTTTTTTTAGTGTGTTGGATTTTGTTTTTTTCACCATCATTATCACTCCTTTTAT
ATAGCTTACAACAAAATAGATGCAAAATTGATTAACTAAATTTAAATTAATTATTAAATC
GAATTTATATTTTTGAGTAAATGTTTTTTGAGTATAAAGATGCTATAAATATAATTGACA
AATGTAATCGGAATTAAGAAATGAAGGTTGTAATGACATTTAAGTTTAAAGCTTGGTATA
AACAAAATCAAACAACATTTTAGGTATTGTAAATTAATTAGTTAATCAAAATTAAAAGAA
CTTTTAACAGTGTTAAAAAATTATTGTTAAAGATAATTTATTATTAATATTCAGTTAATT
CAAAAAATAGAGAAAGTCTGGCTATAATTAAGTTGCAATCACGAATTACATAAAAAAGGA
GAGATAATTT
> Genome: IMT38884 | Promoter-Region (Gene): map_eap
CGATAACATATAAACGTTATGACTGACTAACTTCAAATCAGTATCATCTTTCTTAGATTC
GGCTTTGGCACTATTGTCTGTCAGTGCCCCAATTAATAATAAATTTGCTAATGCAAGTGT
TGCAGCTTTTTTTAGTGTGTTGGATTTTGTTTTTTTCACCATCATTATCACTCCTTTTAT
ATAGCTTACAACAAAATAGATGCAAAATTGATTAACTAAATTTAAATTAATTATTAAATC
GAATTTATATTTTTGAGTAAATGTTTTTTGAGTATAAAGATGCTATAAATATAATTGACA
AATGTAATCGGAATTAAGAAATGAAGGTTGTAATGACATTTAAGTTTAAAGCTTGGTATA
AACAAAATCAAACAACATTTTAGGTATTGTAAATTAATTAGTTAATCAAAATTAAAAGAA
CTTTTAACAGTGTTAAAAAATTATTGTTAAAGATAATTTATTATTAATATTCAGTTAATT
CAAAAAATAGAGAAAGTCTGGCTATAATTAAGTTGCAATCACGAATTACATAAAAAAGGA
GAGATAATTT
> Genome: IMT38885 | Promoter-Region (Gene): map_eap
CGATAACATATAAACGTTATGACTGACTAACTTCAAATCAGTATCATCTTTCTTAGATTC
GGCTTTGGCACTATTGTCTGTCAGTGCCCCAATTAATAATAAATTTGCTAATGCAAGTGT
TGCAGCTTTTTTTAGTGTGTTGGATTTTGTTTTTTTCACCATCATTATCACTCCTTTTAT
ATAGCTTACAACAAAATAGATGCAAAATTGATTAACTAAATTTAAATTAATTATTAAATC
GAATTTATATTTTTGAGTAAATGTTTTTTGAGTATAAAGATGCTATAAATATAATTGACA
AATGTAATCGGAATTAAGAAATGAAGGTTGTAATGACATTTAAGTTTAAAGCTTGGTATA
AACAAAATCAAACAACATTTTAGGTATTGTAAATTAATTAGTTAATCAAAATTAAAAGAA
CTTTTAACAGTGTTAAAAAATTATTGTTAAAGATAATTTATTATTAATATTCAGTTAATT
CAAAAAATAGAGAAAGTCTGGCTATAATTAAGTTGCAATCACGAATTACATAAAAAAGGA
GAGATAATTT
> Genome: IMT38886 | Promoter-Region (Gene): map_eap
CGATAACATATAAACGTTATGACTGACTAACTTCAAATCAGTATCATCTTTCTTAGATTC
GGCTTTGGCACTATTGTCTGTCAGTGCCCCAATTAATAATAAATTTGCTAATGCAAGTGT
TGCAGCTTTTTTTAGTGTGTTGGATTTTGTTTTTTTCACCATCATTATCACTCCTTTTAT
ATAGCTTACAACAAAATAGATGCAAAATTGATTAACTAAATTTAAATTAATTATTAAATC
GAATTTATATTTTTGAGTAAATGTTTTTTGAGTATAAAGATGCTATAAATATAATTGACA
AATGTAATCGGAATTAAGAAATGAAGGTTGTAATGACATTTAAGTTTAAAGCTTGGTATA
AACAAAATCAAACAACATTTTAGGTATTGTAAATTAATTAGTTAATCAAAATTAAAAGAA
CTTTTAACAGTGTTAAAAAATTATTGTTAAAGATAATTTATTATTAATATTCAGTTAATT
CAAAAAATAGAGAAAGTCTGGCTATAATTAAGTTGCAATCACGAATTACATAAAAAAGGA
GAGATAATTT
> Genome: IMT38887 | Promoter-Region (Gene): map_eap
CGATAACATATAAACGTTATGACTGACTAACTTCAAATCAGTATCATCTTTCTTAGATTC
GGCTTTGGCACTATTGTCTGTCAGTGCCCCAATTAATAATAAATTTGCTAATGCAAGTGT
TGCAGCTTTTTTTAGTGTGTTGGATTTTGTTTTTTTCACCATCATTATCACTCCTTTTAT
ATAGCTTACAACAAAATAGATGCAAAATTGATTAACTAAATTTAAATTAATTATTAAATC
GAATTTATATTTTTGAGTAAATGTTTTTTGAGTATAAAGATGCTATAAATATAATTGACA
AATGTAATCGGAATTAAGAAATGAAGGTTGTAATGACATTTAAGTTTAAAGCTTGGTATA
AACAAAATCAAACAACATTTTAGGTATTGTAAATTAATTAGTTAATCAAAATTAAAAGAA
CTTTTAACAGTGTTAAAAAATTATTGTTAAAGATAATTTATTATTAATATTCAGTTAATT
CAAAAAATAGAGAAAGTCTGGCTATAATTAAGTTGCAATCACGAATTACATAAAAAAGGA
GAGATAATTT
> Genome: IMT38951 | Promoter-Region (Gene): map_eap
CGATAACATATAAACGTTATGACTGACTAACTTCAAATCAGTATCATCTTTCTTAGATTC
GGCTTTGGCACTATTGTCTGTCAGTGCCCCAATTAATAATAAATTTGCTAATGCAAGTGT
TGCAGCTTTTTTTAGTGTGTTGGATTTTGTTTTTTTCACCATCATTATCACTCCTTTTAT
ATAGCTTACAACAAAATAGATGCAAAATTGATTAACTAAATTTAAATTAATTATTAAATC
GAATTTATATTTTTGAGTAAATGTTTTTTGAGTATAAAGATGCTATAAATATAATTGACA
AATGTAATCGGAATTAAGAAATGAAGGTTGTAATGACATTTAAGTTTAAAGCTTGGTATA
AACAAAATCAAACAACATTTTAGGTATTGTAAATTAATTAGTTAATCAAAATTAAAAGAA
CTTTTAACAGTGTTAAAAAATTATTGTTAAAGATAATTTATTATTAATATTCAGTTAATT
CAAAAAATAGAGAAAGTCTGGCTATAATTAAGTTGCAATCACGAATTACATAAAAAAGGA
GAGATAATTT
